3 6 3 3 0 0 3 3 6 3
3 3 3 6 0 0 6 3 3 6
3 3 6 3 0 0 3 3 3 3
3 2 3 3 0 0 3 2 6 3
2 5 2 2 0 0 2 2 2 5
2 2 5 2 0 0 5 2 2 2
2 4 4 2 0 0 2 1 4 2
1 1 1 1 0 0 1 4 4 1
3 3 4 3 0 0 3 3 4 3
1 3 3 4 0 0 1 3 3 1