1 1 1 1 1 1 1 1 1 1
0 2 2 2 2 2 2 2 2 0
0 0 1 1 3 6 1 1 0 0
0 0 0 5 2 2 2 0 0 0
0 0 0 0 1 4 0 0 0 0
0 0 0 0 0 0 0 0 0 0
0 0 0 0 0 0 0 0 0 0
1 1 0 0 0 0 0 0 1 1
1 1 0 0 0 0 0 0 1 1
1 1 0 0 0 0 0 0 1 1