1 1 1 1 4 1 1 1 4 1
0 2 2 5 2 2 2 2 5 0
0 0 4 4 3 6 4 4 0 0
0 0 0 5 2 2 5 0 0 0
0 0 0 0 6 3 0 0 0 0
0 0 0 0 0 0 0 0 0 0
0 0 0 0 0 0 0 0 0 0
1 1 0 0 0 0 0 0 1 1
1 1 0 0 0 0 0 0 1 1
1 1 0 0 0 0 0 0 1 1