2 5 2 2 5 2 2 5 2 2
2 1 4 1 1 1 4 1 1 2
2 1 0 0 0 0 0 0 4 2
5 4 0 6 3 3 3 0 1 5
2 1 0 6 3 6 3 0 1 2
2 4 0 3 6 3 3 0 4 5
2 1 0 0 0 0 0 0 1 2
5 1 0 0 0 0 0 0 1 5
2 4 0 0 0 0 0 0 4 2
2 1 0 0 0 0 0 0 1 2